{"tileMap":[
    [
        [10,10,10,10,10,10,10,10,10,10,10,10,10,10,10,10,10,10,10,10,10,10],
        [0,0,0,0,0,0,0,0,0,0,11,11,11,11,11,11,11,11,11,11,11,11]
    ],
    [
        [10,10,10,12,10,10,10,10,10,10,10,10,10,10,10,10,10,10,10,10,10,10],
        [0,0,0,0,0,0,0,0,0,0,11,11,11,11,11,11,11,11,11,11,11,11]
    ],
    [
        [10,10,10,12,10,10,10,10,10,10,10,10,10,10,10,10,10,10,10,10,10,10],
        [0,0,0,0,0,0,0,0,0,0,11,11,11,11,11,11,11,11,11,11,11,11]
    ],




    [
        [10,10,10,12,10,10,10,10,10,10,10,10,10,10,10,10,10,10,10,10,10,10],
        [0,0,0,0,0,0,0,0,0,0,0,30,0,0,0,0,0,0,0,11,11,11]
    ],
    [
        [10,10,10,12,10,10,10,10,10,10,10,10,10,10,10,10,10,10,10,10,10,10],
        [0,0,0,0,0,0,0,0,0,0,0,30,0,0,0,0,0,0,0,11,11,11]
    ],
    [
        [10,10,10,12,10,10,10,10,10,10,10,10,10,10,10,10,10,10,10,10,10,10],
        [0,0,0,0,0,0,0,0,0,0,0,30,0,0,0,0,0,0,0,11,11,11]
    ],




    [
        [10,10,10,12,10,10,10,10,10,10,10,10,10,10,10,10,10,10,10,10,10,10],
        [0,0,0,0,0,0,0,0,0,0,11,11,11,0,0,0,0,0,0,11,11,11]
    ],
    [
        [10,10,10,12,10,10,10,10,10,10,10,10,10,10,10,13,10,10,10,10,10,10],
        [0,0,0,0,0,0,0,0,0,0,13,11,11,0,0,0,0,0,0,11,11,11]
    ],
    [
        [10,10,10,12,10,10,10,10,10,10,10,10,10,10,10,10,10,10,10,10,10,10],
        [0,0,0,0,0,0,0,0,0,0,11,11,11,0,0,0,0,0,0,11,11,11]
    ],



    
    [
        [10,10,10,12,10,10,10,10,10,10,10,10,10,10,10,10,10,10,10,10,10,10],
        [0,0,0,0,0,0,0,0,0,0,0,30,0,0,0,0,0,0,0,11,11,11]
    ],
    [
        [10,10,10,12,12,12,12,12,12,12,12,12,12,12,12,12,12,10,10,10,10,10],
        [0,0,0,0,0,0,0,0,0,0,0,30,0,0,0,0,0,0,0,11,11,11]
    ],
    [
        [10,10,10,10,10,10,10,10,10,10,10,10,10,10,10,10,12,10,10,10,10,10],
        [0,0,0,0,0,0,0,0,0,0,0,30,0,0,0,0,0,0,0,20,11,11]
    ],





    [
        [10,10,10,10,10,10,10,10,10,10,10,10,10,10,10,10,12,10,10,10,10,10],
        [0,0,0,0,0,0,0,0,0,0,11,11,11,0,0,0,0,0,0,11,11,11]
    ],
    [
        [10,10,10,10,10,10,10,10,10,10,10,10,13,10,10,10,12,10,10,13,10,10],
        [0,0,0,0,0,0,0,0,0,0,13,11,11,0,0,0,0,0,0,11,11,11]
    ],
    [
        [10,10,10,10,10,10,10,10,10,10,10,10,10,10,10,10,12,10,10,10,10,10],
        [0,0,0,0,0,0,0,0,0,0,11,11,11,0,0,0,0,0,0,11,11,11]
    ],




    [
        [10,10,10,10,10,10,10,10,10,10,10,10,10,10,10,10,12,10,10,10,10,10],
        [0,0,0,0,0,0,0,0,0,0,0,30,0,0,0,0,0,0,0,11,11,11]
    ],
    [
        [10,10,10,12,12,12,12,12,12,12,12,12,12,12,12,12,12,10,10,10,10,10],
        [0,0,0,0,0,0,0,0,0,0,0,30,0,0,0,0,0,0,0,11,11,11]
    ],
    [
        [10,10,10,12,10,10,10,10,10,10,10,10,10,10,10,10,10,10,10,10,10,10],
        [0,0,0,0,0,0,0,0,0,0,0,30,0,0,0,0,0,0,0,11,11,11]
    ],




    [
        [10,10,10,12,10,10,10,10,10,10,10,10,10,10,10,10,10,10,10,10,10,10],
        [0,0,0,0,0,0,0,0,0,0,11,11,11,0,0,0,0,0,0,11,11,11]
    ],
    [
        [10,10,10,12,10,10,10,10,10,10,10,10,10,10,10,13,10,10,10,10,10,10],
        [0,0,0,0,0,0,0,0,0,0,13,11,11,0,0,0,0,0,0,11,11,11]
    ],
    [
        [10,10,10,12,10,10,10,10,10,10,10,10,10,10,10,10,10,10,10,10,10,10],
        [0,0,0,0,0,0,0,0,0,0,11,11,11,0,0,0,0,0,0,11,11,11]
    ],





    [
        [10,10,10,12,10,10,10,10,10,10,10,10,10,10,10,10,10,10,10,10,10,10],
        [0,0,0,0,0,0,0,0,0,0,0,30,0,0,0,0,0,0,0,11,11,11]
    ],
    [
        [10,10,10,12,12,12,12,12,12,12,12,12,12,12,12,12,12,10,10,10,10,10],
        [0,0,0,0,0,0,0,0,0,0,0,30,0,0,0,0,0,0,0,11,11,11]
    ],
    [
        [10,10,10,10,10,10,10,10,10,10,10,10,10,10,10,10,12,10,10,10,10,10],
        [0,0,0,0,0,0,0,0,0,0,0,30,0,0,0,0,0,0,0,11,11,11]
    ],



    [
        [10,10,10,10,10,10,10,10,10,10,10,10,10,10,10,10,12,10,10,10,10,10],
        [0,0,0,0,0,0,0,0,0,0,11,11,11,0,0,0,0,0,0,11,11,11]
    ],
    [
        [10,10,10,10,10,10,10,10,10,10,10,10,10,10,10,10,12,10,10,10,10,10],
        [0,0,0,0,0,0,0,0,0,0,13,11,11,0,0,0,0,0,0,11,11,11]
    ],
    [
        [10,10,10,10,10,10,10,10,10,10,10,10,10,10,10,10,12,10,10,10,10,10],
        [0,0,0,0,0,0,0,0,0,0,11,11,11,0,0,0,0,0,0,11,11,11]
    ],



    [
        [10,10,10,10,10,10,10,10,10,10,10,10,10,10,10,10,12,10,10,10,10,10],
        [0,0,0,0,0,0,0,0,0,0,0,30,0,0,0,0,0,0,0,11,11,11]
    ],
    [  
        [10,10,10,12,12,12,12,12,12,12,12,12,12,12,12,12,12,10,10,10,10,10],
        [0,0,0,0,0,0,0,0,0,0,0,30,0,0,0,0,0,0,0,11,11,11]
    ],
    [
        [10,10,10,12,10,10,10,10,10,10,10,10,10,10,10,10,10,10,10,10,10,10],
        [0,0,0,0,0,0,0,0,0,0,0,30,0,0,0,0,0,0,0,11,11,11]
    ],

    [
        [10,10,10,12,10,10,10,10,10,10,10,10,10,10,10,10,10,10,10,10,10,10],
        [0,0,0,0,0,0,0,0,0,0,13,11,11,11,11,11,11,11,11,11,11,11]
    ],
    [
        [10,10,10,12,10,10,10,10,10,10,10,10,10,10,10,10,10,10,10,10,10,10],
        [0,0,0,0,0,0,0,0,0,0,11,11,11,11,11,11,11,11,11,11,11,11]
    ],
    [
        [10,10,10,12,10,10,10,10,10,10,10,10,10,10,10,10,10,10,10,10,10,10],
        [0,0,0,0,0,0,0,0,0,0,11,11,11,11,11,11,11,11,11,11,11,11]
    ],
    [
        [0,0,11,11,11],
        [0,0,11,12,11],
        [0,0,11,12,11],
        [0,0,11,11,11]
    ]

],
"MapLookup":{
               "0": {"object": "nul", "material": "unused", "isbuildable": false,"isPath": false, "rotation": 0, "scaleFactors":{"x":0.5,"y":0.5,"z":0.5}},
               "10": {"object": "GrassBlock01D.obj", "material": "..\\Assets\\WorldMapAssets\\GrassBlock01D.mtl", "isbuildable": false,"isPath": false, "rotation": 0, "scaleFactors":{"x":0.5,"y":0.5,"z":0.5}},
               "11": {"object": "Floor01.obj", "material": "..\\Assets\\WorldMapAssets\\Floor01.mtl", "isbuildable": false,"isPath": false, "rotation": 0, "scaleFactors":{"x":0.5,"y":0.5,"z":0.5}},
               "12": {"object": "PathBlock01D.obj", "material": "..\\Assets\\WorldMapAssets\\PathBlock01D.mtl", "isbuildable": false,"isPath": true, "rotation": 0, "scaleFactors":{"x":0.5,"y":0.5,"z":0.5}},
               "13": {"object": "BuildableBlock01D.obj", "material": "..\\Assets\\WorldMapAssets\\BuildableBlock01D.mtl", "isbuildable": true, "isPath": false, "rotation": 0, "scaleFactors":{"x":0.5,"y":0.5,"z":0.5}},
               "20": {"object": "Step01D.obj", "material": "..\\Assets\\WorldMapAssets\\Step01D.mtl", "isbuildable": false,"isPath": false, "rotation": 180, "scaleFactors":{"x":0.5,"y":0.5,"z":0.5}},
               "30": {"object": "Bridge01D.obj", "material": "..\\Assets\\WorldMapAssets\\Bridge01D.mtl", "isbuildable": false,"isPath": false, "rotation": 180, "scaleFactors":{"x":0.5,"y":0.5,"z":0.5}}
             }
}
